111111111111111111111111111
11100011111100000111100C001
110000000000001000001100011
100C1C001111000001101000001
100111001111110111101100011
100C1C001111110111101110111
110000011111000110000000001
110000111111011110111000001
110111111111011110111100011
1101111CC010001000011000001
100011101010101000011100011
100011100010001000011000001
100011110111011000011100011
100000000000000000110000001
100011110111011101111100011
100011100010001000011000001
100011101010101000001100001
100000100C10C010000C1000001
100010111111111111111100011
10001000000E11111111100P001
111111111111111111111111111
