1111111111111111111111111111111111
1E000000000C0000000000000C00000001
1010101001010000101001000000010101
1010010010101011001001000000010101
1P0000000C00C0000000000000000000C1
1111111111111111111111111111111111
